TILEMAP
63 63 							-- Size of tile map in tiles
16 16 							-- Tile size & block size
images/Patrones.png 	-- Tilesheet
8 8 								-- Number of tiles in tilesheet
56,56,56,56,56,56,56,56,56,56,56,56,56,56,56,56,56,56,56,56,56,56,56,56,56,56,56,56,56,56,56,56,56,56,56,56,56,56,56,56,56,56,56,56,56,56,56,56,56,56,56,56,56,56,56,56,56,56,56,56,56,56,56,
56,56,56,56,56,56,56,56,56,56,56,56,56,56,56,56,56,56,56,56,56,56,56,56,56,56,56,56,56,56,56,56,56,56,56,56,56,56,56,56,56,56,56,56,56,56,56,56,56,56,56,56,56,56,56,56,56,56,56,56,56,56,56,
56,56,56,56,56,56,56,56,56,56,56,56,56,56,56,56,56,56,56,56,56,56,56,56,56,56,56,56,56,56,56,56,56,56,56,56,56,56,56,56,56,56,56,56,56,56,56,56,56,56,56,56,56,56,56,56,56,56,56,56,56,56,56,
32,33,34,41,41,41,41,41,41,41,41,41,41,41,41,41,41,41,41,41,41,41,41,41,41,41,41,41,41,32,33,34,41,41,41,41,41,41,41,41,41,41,41,41,41,41,41,41,41,41,41,41,41,41,41,41,41,41,41,41,32,33,34,
40,41,42,39,39,39,39,39,39,39,39,39,39,39,39,39,39,39,39,39,39,39,39,39,39,39,39,39,39,40,41,42,39,39,39,39,39,39,39,39,39,39,39,39,39,39,39,39,39,39,39,39,39,39,39,39,39,39,39,39,40,41,42,
48,49,50,41,41,41,41,41,41,41,41,41,41,41,41,41,41,41,41,41,41,41,41,41,41,41,41,41,41,48,49,50,41,41,41,41,41,41,41,41,41,41,41,41,41,41,41,41,41,41,41,41,41,41,41,41,41,41,41,41,48,49,50,
41,55,41,41,41,41,41,41,41,41,41,41,41,41,41,41,41,41,41,41,41,41,41,41,41,41,41,41,41,41,55,41,41,41,41,41,41,41,41,41,41,41,41,41,41,41,41,41,41,41,41,41,41,41,41,41,41,41,41,41,41,55,41,
41,55,41,41,41,41,41,41,41,41,41,41,41,41,41,41,41,41,41,41,41,41,41,41,41,41,41,41,41,41,55,41,41,41,41,41,41,41,41,41,41,41,41,41,41,41,41,41,41,41,41,41,41,41,41,41,41,41,41,41,41,55,41,
41,55,41,41,41,41,41,41,41,41,41,41,41,41,41,41,41,41,41,41,41,41,41,41,41,41,41,41,41,41,55,41,41,41,41,41,41,41,41,41,41,41,41,41,41,41,41,41,41,41,41,41,41,41,41,41,41,41,41,41,41,55,41,
41,55,41,41,41,41,41,41,41,41,41,41,41,41,41,41,41,41,41,41,41,41,41,41,41,41,41,41,41,41,55,41,41,41,41,41,41,41,41,41,41,41,41,41,41,41,41,41,41,41,41,41,41,41,41,41,41,41,41,41,41,55,41,
41,55,41,56,56,56,56,56,56,56,56,56,56,56,56,56,56,56,56,56,56,56,56,56,56,56,56,56,56,41,55,41,56,56,56,56,56,56,56,56,56,56,56,56,56,56,56,56,56,56,56,56,56,56,56,56,56,56,56,56,41,55,41,
41,55,41,56,56,56,56,56,56,56,56,56,56,56,56,56,56,56,56,56,56,56,56,56,56,56,56,56,56,41,55,41,56,56,56,56,56,56,56,56,56,56,56,56,56,56,56,56,56,56,56,56,56,56,56,56,56,56,56,56,41,55,41,
41,55,41,56,56,56,56,56,56,56,56,56,56,56,56,56,56,56,56,56,56,56,56,56,56,32,33,34,56,41,55,41,56,56,56,56,56,56,56,56,56,56,56,56,56,56,56,56,56,56,56,56,56,56,56,56,56,56,56,56,41,55,41,
41,55,41,56,56,56,56,56,56,56,56,56,56,56,56,56,56,56,56,56,56,56,56,56,56,40,56,42,56,41,55,41,56,56,56,56,56,56,56,56,56,56,56,56,56,56,56,56,56,56,56,56,32,33,34,56,56,56,56,56,41,55,41,
41,55,41,56,56,56,56,56,56,56,56,56,56,56,56,56,56,56,56,56,56,56,56,56,56,40,56,42,56,41,55,41,56,56,56,56,56,56,56,56,56,56,56,56,56,56,56,56,56,56,56,56,40,56,42,56,56,56,56,5,41,55,41,
41,55,41,56,56,56,56,56,56,56,56,56,56,56,56,56,25,49,49,49,49,49,49,49,49,49,49,49,49,41,55,41,56,56,56,56,56,56,56,56,56,56,56,56,56,56,56,56,56,56,56,56,40,56,42,56,56,56,56,56,41,55,41,
41,55,41,56,56,56,56,56,56,56,56,56,56,56,56,56,56,56,56,56,56,56,56,56,56,56,56,56,56,41,55,41,56,56,25,49,49,49,49,49,49,49,49,49,49,49,49,49,49,49,49,49,49,49,49,49,49,49,49,49,41,55,41,
41,55,41,56,56,56,56,56,56,56,56,56,56,56,56,56,56,56,56,56,56,56,56,56,56,56,56,56,56,41,55,41,56,56,56,56,56,56,56,56,56,56,56,56,56,56,56,56,56,56,56,56,56,56,56,56,56,56,56,56,41,55,41,
41,55,41,56,56,56,56,56,56,56,56,56,56,56,56,56,56,56,56,56,56,56,56,56,56,56,56,56,56,56,56,56,56,56,56,56,56,56,56,56,56,56,56,56,56,56,56,56,56,56,56,56,56,56,56,56,56,56,56,56,41,55,41,
41,55,41,56,56,56,56,56,56,56,56,56,56,56,56,56,56,56,56,56,56,56,56,56,56,56,56,56,56,56,56,56,56,56,56,56,56,56,56,56,56,56,56,56,56,56,56,56,56,56,56,56,56,56,56,56,56,56,56,56,41,55,41,
41,55,41,56,56,56,56,25,49,49,49,2,49,26,56,56,56,56,56,56,56,56,56,56,56,56,56,56,56,56,56,56,56,56,56,56,56,56,56,56,56,56,56,56,56,56,56,56,56,56,56,56,56,56,56,56,56,56,56,56,41,55,41,
41,55,41,56,56,56,56,56,56,56,56,2,56,56,56,56,56,56,56,56,56,56,56,56,56,56,56,56,56,56,56,56,56,56,56,56,56,56,56,56,56,56,56,56,56,56,56,56,56,56,56,56,56,56,56,56,25,49,49,49,41,55,41,
41,55,41,56,56,56,56,56,56,56,56,2,56,56,56,56,56,56,56,56,56,56,56,25,49,49,2,49,49,49,49,49,49,49,49,26,56,56,56,56,56,56,56,56,56,56,56,56,56,56,56,56,56,56,56,56,56,56,56,56,41,55,41,
41,55,41,56,56,56,56,56,56,56,56,2,56,56,56,56,56,56,56,56,56,56,56,56,56,56,2,56,56,41,55,41,56,56,56,56,56,56,56,56,56,56,56,56,56,56,56,56,25,49,49,49,49,49,26,56,56,56,56,56,41,55,41,
41,55,41,56,56,56,56,56,56,56,56,2,56,56,56,56,56,56,56,56,56,56,56,56,56,56,2,56,56,41,55,41,56,56,56,56,56,56,56,56,56,56,56,56,56,56,56,56,56,56,56,56,56,56,56,56,56,56,56,56,41,55,41,
41,55,41,56,56,56,56,56,56,56,56,2,56,56,56,56,56,56,56,56,56,56,56,56,56,56,2,56,56,41,55,41,56,56,56,56,25,49,49,2,49,49,49,49,49,26,56,56,56,56,56,56,56,56,56,56,56,56,56,56,41,55,41,
41,55,41,56,56,56,56,56,56,56,25,49,49,49,49,49,26,56,56,56,56,56,56,56,56,56,2,56,56,41,55,41,56,56,56,56,56,56,56,2,56,56,56,56,56,56,56,56,56,56,56,56,56,56,56,56,56,56,56,56,41,55,41,
41,55,41,56,56,56,56,56,56,56,56,56,56,56,56,56,56,56,56,56,56,56,56,56,56,56,2,56,56,41,55,41,56,56,56,56,56,56,56,2,56,56,56,56,56,56,56,56,56,56,56,56,56,56,56,56,56,56,56,56,41,55,41,
41,55,41,56,56,56,56,56,56,56,56,56,56,56,56,56,56,56,56,56,56,56,56,56,56,56,2,56,56,41,55,41,56,56,56,56,56,56,56,2,56,56,56,56,56,56,56,56,56,56,56,56,56,56,56,56,56,56,56,56,41,55,41,
41,55,41,56,56,56,56,56,56,56,56,56,56,56,56,56,56,56,56,56,56,56,56,56,56,56,2,56,56,41,55,41,56,56,56,56,56,56,56,2,56,56,56,56,56,56,56,56,56,56,56,56,56,56,56,56,56,56,56,56,41,55,41,
41,55,41,56,56,56,56,56,56,56,56,56,56,56,56,56,56,56,56,56,56,56,56,56,56,56,2,56,56,41,55,41,56,56,56,56,56,56,56,2,56,56,56,56,56,56,56,56,56,56,56,56,56,56,56,56,56,56,56,56,41,55,41,
32,33,34,49,49,49,49,49,49,49,49,49,49,49,49,49,49,49,49,49,49,49,49,49,49,49,49,49,49,32,33,34,49,49,49,49,49,49,49,49,49,49,49,49,49,49,49,49,49,49,49,49,49,49,49,2,49,49,49,49,32,33,34,
40,41,42,29,29,29,29,29,29,29,29,29,29,29,29,29,29,29,29,29,29,29,29,29,29,29,29,29,29,40,41,42,29,29,29,29,29,29,29,29,29,29,29,29,29,29,29,29,29,29,29,29,29,29,29,2,29,29,29,29,40,41,42,
48,49,50,33,33,33,33,33,33,33,33,33,33,33,33,33,33,33,33,33,33,33,33,33,33,33,33,33,33,48,49,50,33,33,33,33,33,33,33,33,33,33,33,33,33,33,33,33,33,33,33,33,33,33,33,2,33,33,33,33,48,49,50,
56,56,56,56,56,56,56,56,56,56,56,56,56,56,56,56,56,56,56,56,56,56,56,56,56,56,56,56,56,41,55,41,56,56,56,56,56,56,56,56,56,56,56,56,56,56,56,56,56,56,56,56,56,56,56,2,56,56,56,56,41,55,41,
56,56,56,56,56,56,56,56,56,56,56,56,56,56,56,56,56,56,56,56,56,56,56,56,56,56,56,56,56,41,55,41,56,56,56,56,56,56,56,56,56,56,56,56,56,56,56,56,56,56,56,56,56,56,56,2,56,56,56,56,41,55,41,
56,56,56,56,56,56,56,56,56,56,56,56,56,56,56,56,56,56,56,56,56,56,56,56,56,56,56,56,56,41,55,41,56,56,56,56,56,56,56,56,56,56,56,56,56,56,56,56,56,56,56,56,56,56,56,2,56,56,56,56,41,55,41,
56,56,56,56,56,56,56,56,56,56,56,56,56,56,56,56,56,56,56,56,56,56,56,56,56,56,56,56,56,41,55,41,56,56,56,56,56,56,56,56,56,56,56,56,56,56,56,56,56,56,56,56,56,56,56,2,56,56,56,56,41,55,41,
56,56,56,56,56,56,56,56,56,56,56,56,56,56,56,56,56,56,56,56,56,56,56,56,56,56,56,56,56,41,55,41,56,56,56,56,56,56,56,56,56,56,56,56,56,56,56,56,56,56,56,25,49,49,49,49,49,49,49,49,41,55,41,
56,56,56,56,56,56,56,56,56,56,56,56,56,56,56,56,56,56,56,56,56,56,56,56,56,56,56,56,56,41,55,41,56,56,56,56,56,56,56,56,56,56,56,56,56,56,56,56,56,56,56,56,56,56,56,56,56,56,56,56,41,55,41,
56,56,56,56,56,56,56,56,56,56,56,56,56,56,56,56,56,56,56,56,56,56,56,56,56,56,56,56,56,41,55,41,56,56,56,56,56,56,56,56,56,56,56,56,56,56,56,25,26,56,56,56,56,56,56,56,56,56,56,56,41,55,41,
56,56,56,56,56,56,56,56,56,56,56,56,56,56,56,56,56,56,56,56,56,56,56,56,56,56,56,56,56,41,55,41,49,49,26,56,56,56,56,56,56,56,56,56,56,56,56,56,56,56,56,56,56,56,56,56,56,56,56,5,41,55,41,
56,56,56,56,56,56,56,56,56,56,56,56,56,56,56,56,56,56,56,56,56,56,56,56,56,56,56,56,56,41,55,41,56,56,56,56,56,56,56,56,56,56,56,56,56,56,56,56,56,56,56,56,56,56,56,56,56,56,56,56,41,55,41,
56,56,56,56,56,56,56,56,56,56,56,56,56,56,56,56,56,56,56,56,56,56,56,56,56,56,56,56,56,41,55,41,56,56,56,56,25,49,49,49,49,49,49,49,49,49,26,56,56,56,56,56,56,56,56,56,56,56,56,56,41,55,41,
56,56,56,56,56,56,56,56,56,56,56,56,56,56,56,56,56,56,56,56,56,56,56,56,56,56,56,56,56,41,55,41,56,56,56,56,56,56,56,56,56,56,56,56,56,56,56,56,56,56,56,56,56,56,56,56,56,56,56,56,41,55,41,
56,56,56,56,56,56,56,56,56,56,56,56,56,56,56,56,56,56,56,56,56,56,56,56,56,56,56,56,56,41,55,41,56,56,56,56,56,56,56,56,56,56,56,56,56,56,56,56,25,49,49,49,26,56,56,56,56,56,56,56,41,55,41,
56,56,56,56,56,56,56,56,56,56,56,56,56,56,56,56,56,56,56,56,56,56,56,56,56,56,56,56,56,41,55,41,56,56,56,56,56,56,56,56,56,56,56,56,56,56,56,56,56,56,56,56,56,56,56,56,56,56,56,56,41,55,41,
56,56,56,56,56,56,56,56,56,56,56,56,56,56,56,56,56,56,56,56,56,56,56,56,56,56,56,56,56,41,55,41,56,56,56,56,56,56,56,56,56,56,56,56,56,56,56,56,56,56,56,56,56,56,25,49,49,26,56,56,41,55,41,
56,56,56,56,56,56,56,56,56,56,56,56,56,56,56,56,56,56,56,56,56,56,56,56,56,56,56,56,56,41,55,41,56,56,56,56,56,56,56,56,56,56,56,56,56,56,56,56,56,56,56,56,56,56,56,56,56,56,56,56,41,55,41,
56,56,56,56,56,56,56,56,56,56,56,56,56,56,56,56,56,56,56,56,56,56,56,56,56,56,56,56,56,41,55,41,56,56,56,56,56,56,56,56,56,56,25,49,2,49,49,49,49,49,49,26,56,56,56,56,56,56,56,56,41,55,41,
56,56,56,56,56,56,56,56,56,56,56,56,56,56,56,56,56,56,56,56,56,56,56,56,56,56,56,56,56,41,55,41,56,56,56,56,56,56,56,56,56,56,56,56,2,56,56,56,56,56,56,56,56,56,56,56,56,56,56,56,41,55,41,
56,56,56,56,56,56,56,56,56,56,56,56,56,56,56,56,56,56,56,56,56,56,56,56,56,56,56,56,56,41,55,41,56,56,56,56,56,56,56,56,56,56,56,56,2,56,56,56,56,56,56,56,56,56,56,56,56,56,56,56,41,55,41,
56,56,56,56,56,56,56,56,56,56,56,56,56,56,56,56,56,56,56,56,56,56,56,56,56,56,56,56,56,41,55,41,56,56,56,56,56,56,56,56,56,56,56,56,2,56,56,56,56,56,56,56,56,56,56,56,56,56,56,56,41,55,41,
56,56,56,56,56,56,56,56,56,56,56,56,56,56,56,56,56,56,56,56,56,56,56,56,56,56,56,56,56,41,55,41,56,56,56,56,56,56,56,56,56,56,56,56,2,56,56,56,56,56,56,56,56,56,56,56,56,56,56,56,41,55,41,
56,56,56,56,56,56,56,56,56,56,56,56,56,56,56,56,56,56,56,56,56,56,56,56,56,56,56,56,56,41,55,41,56,56,56,56,56,56,56,56,56,56,56,56,2,56,56,56,56,56,56,56,37,29,38,56,56,56,56,56,41,55,41,
56,56,56,56,56,56,56,56,56,56,56,56,56,56,56,56,56,56,56,56,56,56,56,56,56,56,56,56,56,41,55,41,56,56,56,56,56,56,56,56,56,56,56,56,2,56,56,56,56,56,56,56,55,51,55,56,56,56,56,5,41,55,41,
56,56,56,56,56,56,56,56,56,56,56,56,56,56,56,56,56,56,56,56,56,56,56,56,56,56,56,56,56,41,55,41,56,56,56,56,56,56,56,56,56,56,56,56,2,56,56,56,56,56,56,56,55,51,55,56,56,56,56,56,41,55,41,
56,56,56,56,56,56,56,56,56,56,56,56,56,56,56,56,56,56,56,56,56,56,56,56,56,56,56,56,56,32,33,34,49,49,49,49,49,49,49,49,49,49,49,49,49,49,49,49,49,49,49,49,49,49,49,49,49,49,49,49,32,33,34,
56,56,56,56,56,56,56,56,56,56,56,56,56,56,56,56,56,56,56,56,56,56,56,56,56,56,56,56,56,40,41,42,29,29,29,29,29,29,29,29,29,29,29,29,29,29,29,29,29,29,29,29,29,29,29,29,29,29,29,29,40,41,42,
56,56,56,56,56,56,56,56,56,56,56,56,56,56,56,56,56,56,56,56,56,56,56,56,56,56,56,56,56,48,49,50,33,33,33,33,33,33,33,33,33,33,33,33,33,33,33,33,33,33,33,33,33,33,33,33,33,33,33,33,48,49,50,
56,56,56,56,56,56,56,56,56,56,56,56,56,56,56,56,56,56,56,56,56,56,56,56,56,56,56,56,56,56,56,56,56,56,56,56,56,56,56,56,56,56,56,56,56,56,56,56,56,56,56,56,56,56,56,56,56,56,56,56,56,56,56,
56,56,56,56,56,56,56,56,56,56,56,56,56,56,56,56,56,56,56,56,56,56,56,56,56,56,56,56,56,56,56,56,56,56,56,56,56,56,56,56,56,56,56,56,56,56,56,56,56,56,56,56,56,56,56,56,56,56,56,56,56,56,56,
56,56,56,56,56,56,56,56,56,56,56,56,56,56,56,56,56,56,56,56,56,56,56,56,56,56,56,56,56,56,56,56,56,56,56,56,56,56,56,56,56,56,56,56,56,56,56,56,56,56,56,56,56,56,56,56,56,56,56,56,56,56,56,