TILEMAP
63 63 							-- Size of tile map in tiles
16 16 							-- Tile size & block size
images/PatronesFinal.png 	-- Tilesheet
48 8 								-- Number of tiles in tilesheet
336,336,336,336,336,336,336,336,336,336,336,336,336,336,336,336,336,336,336,336,336,336,336,336,336,336,336,336,336,336,336,336,336,336,336,336,336,336,336,336,336,336,336,336,336,336,336,336,336,336,336,336,336,336,336,336,336,336,336,336,336,336,336,
336,336,336,336,336,336,336,336,336,336,336,336,336,336,336,336,336,336,336,336,336,336,336,336,336,336,336,336,336,336,336,336,336,336,336,336,336,336,336,336,336,336,336,336,336,336,336,336,336,336,336,336,336,336,336,336,336,336,336,336,336,336,336,
336,336,336,336,336,336,336,336,336,336,336,336,336,336,336,336,336,336,336,336,336,336,336,336,336,336,336,336,336,336,336,336,336,336,336,336,336,336,336,336,336,336,336,336,336,336,336,336,336,336,336,336,336,336,336,336,336,336,336,336,336,336,336,
208,209,210,257,257,257,257,257,257,257,257,257,257,257,257,257,257,257,257,257,257,257,257,257,257,257,257,257,257,208,209,210,257,257,257,257,257,257,257,257,257,257,257,257,257,257,257,257,257,257,257,215,215,215,215,215,215,215,215,215,208,209,210,
256,257,258,215,215,215,215,215,215,215,215,215,215,215,215,215,215,215,215,215,215,215,215,215,215,215,215,215,215,256,257,258,215,215,215,215,215,215,215,215,215,215,215,215,215,215,215,215,215,215,215,215,215,215,215,215,215,215,215,215,256,257,258,
304,305,306,257,257,257,257,257,257,257,257,257,257,257,257,257,257,257,257,257,257,257,257,257,257,257,257,257,257,304,305,306,257,257,257,257,257,257,257,257,257,257,257,257,257,257,257,257,257,257,257,257,257,257,257,257,257,257,257,257,304,305,306,
257,311,257,336,336,336,336,336,336,336,336,336,336,336,336,336,336,336,336,336,336,336,336,336,336,336,336,336,336,257,311,257,336,336,336,336,336,336,336,336,336,336,336,336,336,336,336,336,336,336,336,336,336,336,336,336,336,336,336,336,257,311,257,
257,311,257,336,336,336,336,336,336,336,336,336,336,336,336,336,336,336,336,336,336,336,336,336,336,336,336,336,336,257,311,257,336,336,336,336,336,336,336,336,336,336,336,336,336,336,336,336,336,336,336,336,336,336,336,336,336,336,336,21,257,311,257,
257,311,257,336,336,208,209,210,336,336,336,336,336,336,336,336,336,336,336,336,336,336,336,336,336,336,336,336,336,257,311,257,336,336,336,336,336,336,336,336,336,336,336,336,336,336,336,336,336,336,336,336,336,336,336,336,336,336,336,336,257,311,257,
257,311,257,336,336,256,336,258,336,336,336,336,336,336,336,336,336,336,336,336,336,336,336,336,336,336,336,336,336,261,311,262,336,336,336,336,161,305,305,305,305,305,305,305,305,305,305,305,305,305,305,162,336,336,336,336,336,336,336,336,257,311,257,
257,311,257,336,336,256,336,258,336,336,336,336,336,336,336,336,336,336,336,336,336,336,336,336,336,336,336,336,336,336,336,336,336,336,336,336,336,336,336,336,336,336,336,336,336,336,336,336,336,336,336,336,336,336,336,336,161,18,305,305,257,311,257,
257,311,257,305,305,305,305,305,305,305,305,305,305,305,305,305,18,162,336,336,336,336,336,336,336,336,336,336,336,336,336,336,336,336,336,336,336,336,336,336,336,336,336,336,336,336,336,336,336,336,336,336,336,336,336,336,336,18,336,336,257,311,257,
257,311,257,336,336,336,336,336,336,336,336,336,336,336,336,336,18,336,336,336,336,336,336,336,336,336,336,336,336,336,336,336,336,336,336,336,336,336,336,336,336,336,336,336,336,336,336,336,336,336,336,336,336,336,336,336,336,18,336,336,257,311,257,
257,311,257,336,336,336,336,336,336,336,336,336,336,336,336,336,18,336,336,336,336,336,336,336,336,336,336,336,336,336,336,336,336,336,336,336,336,336,336,336,336,336,336,336,336,161,18,305,305,305,305,305,162,336,336,336,336,18,336,336,257,311,257,
257,311,257,336,336,336,336,336,336,336,336,336,336,336,336,336,18,336,336,336,336,336,336,336,161,18,305,305,305,305,305,305,305,305,162,336,336,336,336,336,336,336,336,336,336,336,18,336,336,336,336,336,336,336,336,336,336,18,336,336,257,311,257,
257,311,257,336,336,336,336,336,336,336,336,336,336,336,336,336,18,336,336,336,336,336,336,336,336,18,336,336,336,257,311,257,336,336,336,336,336,336,336,336,336,336,336,336,336,336,18,336,336,336,336,336,336,336,336,161,305,305,305,305,257,311,257,
257,311,257,336,336,336,336,336,336,336,336,336,336,336,336,336,18,336,336,336,336,336,336,336,336,18,336,336,336,257,311,257,336,336,336,336,336,336,336,336,336,336,336,336,336,336,18,336,336,336,336,336,336,336,336,336,336,336,336,336,257,311,257,
257,311,257,336,336,336,336,336,336,336,336,336,336,336,336,336,18,336,336,336,336,336,336,336,336,18,336,336,21,257,311,257,336,336,336,336,336,336,336,336,336,336,336,336,336,336,18,336,336,336,336,336,336,336,336,336,336,336,336,336,257,311,257,
257,311,257,336,336,336,336,336,336,336,336,336,336,336,336,336,18,336,336,336,336,336,336,336,336,18,336,336,336,257,311,257,336,336,336,336,336,336,336,336,336,336,336,336,336,336,18,336,336,336,336,336,336,336,336,336,336,336,336,336,257,311,257,
257,311,257,336,336,336,161,305,305,305,305,305,305,305,305,305,305,305,305,305,305,305,305,305,305,162,336,336,336,257,311,257,336,336,336,161,305,305,305,305,305,305,305,305,305,305,305,305,305,305,18,305,305,305,305,162,336,336,336,336,257,311,257,
257,311,257,336,336,336,336,336,336,336,336,336,336,336,336,336,336,336,336,336,336,336,336,336,336,336,336,336,336,257,311,257,336,336,336,336,336,336,336,336,336,336,336,336,336,336,336,336,336,336,18,336,336,336,336,336,336,336,336,336,257,311,257,
257,311,257,336,336,336,336,336,336,336,336,336,336,336,336,336,336,336,336,336,336,336,336,336,336,336,336,336,336,257,311,257,336,336,336,336,336,336,336,336,336,336,336,336,336,336,336,336,336,336,18,336,336,336,336,336,336,336,336,336,257,311,257,
257,311,257,336,336,336,336,336,336,336,336,336,336,336,161,305,305,305,305,305,162,336,336,336,336,336,336,336,336,257,311,257,336,336,336,336,336,336,336,336,336,336,336,336,336,336,336,336,336,336,18,336,336,336,336,336,336,336,336,21,257,311,257,
257,311,257,336,336,336,336,336,336,336,336,336,336,336,336,336,336,336,336,336,336,336,336,336,336,336,336,336,336,257,311,257,336,336,336,336,336,336,336,336,336,336,336,336,336,336,336,336,336,336,18,336,336,336,336,336,336,336,336,336,257,311,257,
257,311,257,336,336,336,161,305,18,305,305,305,162,336,336,336,336,336,336,336,336,336,336,336,336,336,336,336,336,257,311,257,336,336,336,336,336,336,336,336,336,336,336,336,336,161,305,305,305,305,305,305,305,305,162,336,336,336,336,336,257,311,257,
257,311,257,336,336,336,336,336,18,336,336,336,336,336,336,336,336,336,336,336,336,336,336,336,336,336,336,336,336,257,311,257,336,336,336,336,336,336,336,336,336,336,336,336,336,336,336,336,336,336,336,336,336,336,336,336,336,336,336,336,257,311,257,
257,311,257,336,336,336,336,336,18,336,336,336,336,336,336,336,336,336,336,336,336,336,336,336,336,336,336,336,336,257,311,257,336,197,149,198,336,336,336,336,161,18,162,336,336,336,336,336,336,336,336,336,336,336,336,336,336,336,336,336,257,311,257,
257,311,257,336,336,336,336,336,18,336,336,336,336,336,336,336,336,336,336,336,336,336,336,336,336,336,336,336,21,257,311,257,336,295,336,295,336,336,336,336,336,18,336,336,336,336,336,336,336,336,336,336,336,336,336,336,336,336,336,336,257,311,257,
257,311,257,336,336,336,336,336,18,336,336,336,336,336,336,336,336,336,336,336,336,336,336,336,336,336,336,336,336,257,311,257,336,295,336,295,336,336,336,336,336,18,336,336,336,336,336,336,336,336,336,336,336,336,336,336,336,336,336,336,257,311,257,
208,209,210,305,305,305,305,305,305,305,305,305,305,305,305,305,305,305,305,305,305,305,305,305,305,305,305,305,305,208,209,210,305,305,305,305,305,305,305,305,305,305,305,305,305,305,305,305,305,305,305,18,305,305,305,305,305,305,305,305,208,209,210,
256,257,258,165,165,165,165,165,165,165,165,165,165,165,165,165,165,165,165,165,165,165,165,165,165,165,165,165,165,256,257,258,165,165,165,165,165,165,165,165,165,165,165,165,165,165,165,165,165,165,165,18,165,165,165,165,165,165,165,165,256,257,258,
304,305,306,209,209,209,209,209,209,209,209,209,209,209,209,209,209,209,209,209,209,209,209,209,209,209,209,209,209,304,305,306,209,209,209,209,209,209,209,209,209,209,209,209,209,209,209,209,209,209,209,18,209,209,209,209,209,209,209,209,304,305,306,
336,336,336,336,336,336,336,336,336,336,336,336,336,336,336,336,336,336,336,336,336,336,336,336,336,336,336,336,336,257,311,257,336,336,336,336,336,336,336,336,336,336,336,336,336,336,336,336,336,336,336,18,336,336,336,336,336,336,336,336,257,311,257,
336,336,336,336,336,336,336,336,336,336,336,336,336,336,336,336,336,336,336,336,336,336,336,336,336,336,336,336,336,257,311,257,336,336,336,336,336,336,336,336,336,336,336,336,336,336,336,336,336,336,336,18,336,336,336,336,336,336,336,336,257,311,257,
336,336,336,336,336,336,336,336,336,336,336,336,336,336,336,336,336,336,336,336,336,336,336,336,336,336,336,336,336,257,311,257,336,336,336,336,336,336,336,336,336,336,336,336,336,336,336,336,336,336,336,18,336,336,336,336,336,336,336,336,257,311,257,
336,336,336,336,336,336,336,336,336,336,336,336,336,336,336,336,336,336,336,336,336,336,336,336,336,336,336,336,336,257,311,257,336,336,336,336,336,336,336,336,336,336,336,336,336,336,336,336,336,336,336,18,336,336,336,336,336,336,336,336,257,311,257,
336,336,336,336,336,336,336,336,336,336,336,336,336,336,336,336,336,336,336,336,336,336,336,336,336,336,336,336,336,257,311,257,305,18,305,305,305,305,305,305,305,162,336,336,336,336,336,336,336,336,336,18,336,336,336,336,336,336,336,336,257,311,257,
336,336,336,336,336,336,336,336,336,336,336,336,336,336,336,336,336,336,336,336,336,336,336,336,336,336,336,336,336,257,311,257,336,18,336,336,336,336,336,336,336,336,336,336,336,336,336,336,336,336,336,18,336,336,336,336,336,336,336,21,257,311,257,
336,336,336,336,336,336,336,336,336,336,336,336,336,336,336,336,336,336,336,336,336,336,336,336,336,336,336,336,336,257,311,257,336,18,336,336,336,336,336,336,336,336,336,336,336,336,336,336,336,336,336,18,336,336,336,336,336,336,336,336,257,311,257,
336,336,336,336,336,336,336,336,336,336,336,336,336,336,336,336,336,336,336,336,336,336,336,336,336,336,336,336,336,257,311,257,336,18,336,336,336,336,336,336,336,336,336,336,161,305,305,305,305,305,305,305,305,305,162,336,336,336,336,336,257,311,257,
336,336,336,336,336,336,336,336,336,336,336,336,336,336,336,336,336,336,336,336,336,336,336,336,336,336,336,336,336,257,311,257,336,18,336,336,336,336,336,336,336,336,336,336,336,336,336,336,336,336,336,336,336,336,336,336,336,336,336,336,257,311,257,
336,336,336,336,336,336,336,336,336,336,336,336,336,336,336,336,336,336,336,336,336,336,336,336,336,336,336,336,336,257,311,257,336,18,336,336,336,336,336,336,336,336,336,336,336,336,336,336,336,336,336,336,336,336,336,336,336,336,336,336,257,311,257,
336,336,336,336,336,336,336,336,336,336,336,336,336,336,336,336,336,336,336,336,336,336,336,336,336,336,336,336,336,257,311,257,305,305,305,162,336,336,336,161,18,305,162,336,336,336,336,336,336,336,336,336,336,336,336,336,336,336,336,336,257,311,257,
336,336,336,336,336,336,336,336,336,336,336,336,336,336,336,336,336,336,336,336,336,336,336,336,336,336,336,336,336,257,311,257,336,336,336,336,336,336,336,336,18,336,336,336,336,336,336,336,336,336,336,336,336,336,336,336,336,336,336,336,257,311,257,
336,336,336,336,336,336,336,336,336,336,336,336,336,336,336,336,336,336,336,336,336,336,336,336,336,336,336,336,336,257,311,257,336,336,336,336,336,336,336,336,18,336,336,336,336,336,336,336,336,336,336,336,336,336,336,336,336,336,336,336,257,311,257,
336,336,336,336,336,336,336,336,336,336,336,336,336,336,336,336,336,336,336,336,336,336,336,336,336,336,336,336,336,257,311,257,336,336,336,336,336,336,336,336,18,336,336,336,336,336,336,336,336,336,336,336,336,336,336,336,336,336,336,336,257,311,257,
336,336,336,336,336,336,336,336,336,336,336,336,336,336,336,336,336,336,336,336,336,336,336,336,336,336,336,336,336,257,311,257,336,336,336,336,336,336,336,336,18,336,336,336,336,336,336,336,336,336,336,336,336,336,336,336,336,336,336,336,257,311,257,
336,336,336,336,336,336,336,336,336,336,336,336,336,336,336,336,336,336,336,336,336,336,336,336,336,336,336,336,336,257,311,257,336,336,336,336,336,336,336,336,18,336,336,336,336,336,336,336,336,336,336,336,336,336,336,336,336,161,305,305,257,311,257,
336,336,336,336,336,336,336,336,336,336,336,336,336,336,336,336,336,336,336,336,336,336,336,336,336,336,336,336,336,257,311,257,336,336,161,305,18,305,305,305,305,305,305,162,336,336,336,336,336,336,336,336,336,336,336,336,336,336,336,336,257,311,257,
336,336,336,336,336,336,336,336,336,336,336,336,336,336,336,336,336,336,336,336,336,336,336,336,336,336,336,336,336,257,311,257,336,336,336,336,18,336,336,336,336,336,336,336,336,336,336,336,336,336,336,336,336,336,336,336,336,336,336,336,257,311,257,
336,336,336,336,336,336,336,336,336,336,336,336,336,336,336,336,336,336,336,336,336,336,336,336,336,336,336,336,336,257,311,257,336,336,336,336,18,336,336,336,336,336,336,336,336,336,336,336,336,336,336,161,305,305,305,305,162,336,336,336,257,311,257,
336,336,336,336,336,336,336,336,336,336,336,336,336,336,336,336,336,336,336,336,336,336,336,336,336,336,336,336,336,257,311,257,336,336,336,336,18,336,336,336,336,336,336,336,336,336,336,336,336,336,336,336,336,336,336,336,336,336,336,336,257,311,257,
336,336,336,336,336,336,336,336,336,336,336,336,336,336,336,336,336,336,336,336,336,336,336,336,336,336,336,336,336,257,311,257,336,336,336,336,18,336,336,336,336,336,336,161,305,305,18,305,162,336,336,336,336,336,336,336,336,336,336,336,257,311,257,
336,336,336,336,336,336,336,336,336,336,336,336,336,336,336,336,336,336,336,336,336,336,336,336,336,336,336,336,336,257,311,257,336,336,336,336,18,336,336,336,336,336,336,336,336,336,18,336,336,336,336,336,208,209,210,336,336,336,336,336,257,311,257,
336,336,336,336,336,336,336,336,336,336,336,336,336,336,336,336,336,336,336,336,336,336,336,336,336,336,336,336,336,257,311,257,336,336,336,336,18,336,336,336,336,336,336,336,336,336,18,336,336,336,336,336,256,336,258,336,336,336,336,21,257,311,257,
336,336,336,336,336,336,336,336,336,336,336,336,336,336,336,336,336,336,336,336,336,336,336,336,336,336,336,336,336,257,311,257,336,336,336,336,18,336,336,336,336,336,336,336,336,336,18,336,336,336,336,336,256,336,258,336,336,336,336,336,257,311,257,
336,336,336,336,336,336,336,336,336,336,336,336,336,336,336,336,336,336,336,336,336,336,336,336,336,336,336,336,336,208,209,210,305,305,305,305,305,305,305,305,305,305,305,305,305,305,305,305,305,305,305,305,305,305,305,305,305,305,305,305,208,209,210,
336,336,336,336,336,336,336,336,336,336,336,336,336,336,336,336,336,336,336,336,336,336,336,336,336,336,336,336,336,256,257,258,165,165,165,165,165,165,165,165,165,165,165,165,165,165,165,165,165,165,165,165,165,165,165,165,165,165,165,165,256,257,258,
336,336,336,336,336,336,336,336,336,336,336,336,336,336,336,336,336,336,336,336,336,336,336,336,336,336,336,336,336,304,305,306,209,209,209,209,209,209,209,209,209,209,209,209,209,209,209,209,209,209,209,209,209,209,209,209,209,209,209,209,304,305,306,
336,336,336,336,336,336,336,336,336,336,336,336,336,336,336,336,336,336,336,336,336,336,336,336,336,336,336,336,336,336,336,336,336,336,336,336,336,336,336,336,336,336,336,336,336,336,336,336,336,336,336,336,336,336,336,336,336,336,336,336,336,336,336,
336,336,336,336,336,336,336,336,336,336,336,336,336,336,336,336,336,336,336,336,336,336,336,336,336,336,336,336,336,336,336,336,336,336,336,336,336,336,336,336,336,336,336,336,336,336,336,336,336,336,336,336,336,336,336,336,336,336,336,336,336,336,336,
336,336,336,336,336,336,336,336,336,336,336,336,336,336,336,336,336,336,336,336,336,336,336,336,336,336,336,336,336,336,336,336,336,336,336,336,336,336,336,336,336,336,336,336,336,336,336,336,336,336,336,336,336,336,336,336,336,336,336,336,336,336,336,
336,336,336,336,336,336,336,336,336,336,336,336,336,336,336,336,336,336,336,336,336,336,336,336,336,336,336,336,336,336,336,336,336,336,336,336,336,336,336,336,336,336,336,336,336,336,336,336,336,336,336,336,336,336,336,336,336,336,336,336,336,336,336,
