TILEMAP
80 80 							-- Size of tile map in tiles
16 16 							-- Tile size & block size
images/Patrones.png 	-- Tilesheet
8 8 								-- Number of tiles in tilesheet
32,33,34,39,39,39,39,39,39,39,39,39,39,39,39,39,39,39,39,39,39,39,39,39,39,39,39,39,39,39,39,39,39,39,39,39,39,39,39,39,39,39,39,39,39,39,39,39,39,39,39,39,39,39,39,39,39,39,39,39,39,39,39,39,39,39,39,39,39,39,39,39,39,39,39,39,39,32,33,34,
40,41,42,41,41,41,41,41,41,41,41,41,41,41,41,41,41,41,41,41,41,41,41,41,41,41,41,41,41,41,41,41,41,41,41,41,41,41,41,41,41,41,41,41,41,41,41,41,41,41,41,41,41,41,41,41,41,41,41,41,41,41,41,41,41,41,41,41,41,41,41,41,41,41,41,41,41,40,41,42,
48,49,50,41,41,41,41,41,41,41,41,41,41,41,41,41,41,41,41,41,41,41,41,41,41,41,41,41,41,41,41,41,41,41,41,41,41,41,41,41,41,41,41,41,41,41,41,41,41,41,41,41,41,41,41,41,41,41,41,41,41,41,41,41,41,41,41,41,41,41,41,41,41,41,41,41,41,48,49,50,
55,41,41,56,56,56,56,56,56,56,56,56,56,56,56,4,56,56,56,56,56,56,56,56,56,56,56,56,56,56,56,56,56,56,56,56,56,56,56,56,41,41,41,56,56,56,56,56,56,56,56,56,56,56,56,56,56,56,56,56,56,56,56,56,56,56,56,56,56,56,56,56,56,56,56,56,56,41,41,55,
55,41,41,56,56,56,56,56,56,56,56,56,56,56,56,56,56,56,56,56,56,56,56,56,56,56,56,56,56,56,56,56,56,56,56,56,56,56,56,56,41,41,41,56,56,56,56,56,56,56,56,56,56,56,56,56,56,56,56,56,56,56,56,56,56,56,56,56,56,56,56,56,56,56,56,56,56,41,41,55,
55,41,41,56,32,33,34,56,56,56,56,56,56,56,56,56,56,56,56,56,56,56,56,56,56,56,56,56,56,56,56,56,56,56,56,56,56,56,56,56,41,41,41,56,56,56,56,56,56,56,56,56,56,56,56,56,56,56,56,56,56,56,56,56,56,56,56,56,56,56,56,56,56,56,56,56,56,41,41,55,
55,41,41,56,40,56,42,56,56,56,56,56,56,56,56,56,56,56,56,56,56,56,56,56,56,56,56,56,56,56,56,56,56,56,56,56,56,56,56,56,41,41,41,56,56,56,56,56,56,56,56,56,56,56,56,56,56,56,56,56,56,56,56,56,56,56,56,56,56,56,56,56,56,56,56,56,56,41,41,55,
55,41,41,56,40,56,42,56,56,56,56,56,56,56,56,56,56,56,56,56,56,56,56,56,56,56,56,56,56,56,56,56,56,56,56,56,56,56,56,56,41,41,41,56,56,56,56,56,56,56,56,56,56,56,56,56,56,56,56,56,56,56,56,56,56,56,56,56,56,56,56,56,56,56,56,56,5,41,41,55,
55,41,41,25,49,49,49,49,49,49,26,56,56,56,56,56,56,56,56,56,56,56,56,56,56,56,56,56,56,56,56,56,56,56,56,56,56,56,56,56,41,41,41,56,56,56,56,56,56,56,56,56,56,56,56,56,56,56,56,56,56,56,56,56,56,56,56,56,56,56,56,56,56,56,56,56,56,41,41,55,
55,41,41,56,56,56,56,56,56,56,56,56,56,56,56,56,56,56,56,56,56,56,56,56,56,56,56,56,56,56,56,56,56,56,56,56,56,56,56,56,41,41,41,56,56,56,56,56,56,56,56,25,49,49,49,49,49,49,49,49,49,49,49,49,26,56,56,56,56,56,56,56,56,56,56,56,56,41,41,55,
55,41,41,56,56,56,56,56,56,56,56,56,56,56,56,56,56,56,56,56,56,56,56,56,56,56,56,56,56,56,56,56,56,56,56,56,56,56,56,56,41,41,41,56,56,56,56,56,56,56,56,56,56,56,56,56,56,56,56,56,56,56,56,56,56,56,56,56,56,56,56,56,56,56,56,56,56,41,41,55,
55,41,41,56,56,56,56,56,56,56,56,25,2,49,49,49,26,56,56,56,56,56,56,56,56,56,56,56,56,56,56,56,56,56,56,56,56,56,56,56,41,41,41,49,49,49,49,26,56,56,56,56,56,56,56,56,56,56,56,56,56,56,56,56,56,56,56,56,56,56,56,56,56,56,56,56,56,41,41,55,
55,41,41,56,56,56,56,56,56,56,56,56,2,56,56,56,56,56,56,56,56,56,56,56,56,56,56,56,56,56,56,56,56,56,56,56,56,56,56,56,41,41,41,56,56,56,56,56,56,56,56,56,56,56,56,56,56,56,56,56,56,56,56,56,56,56,56,56,56,56,56,56,56,56,56,56,56,41,41,55,
55,41,41,56,56,56,56,56,56,56,56,56,2,56,56,56,56,56,56,56,56,56,56,56,56,56,56,56,56,56,56,56,56,56,56,56,56,56,56,56,41,41,41,56,56,56,56,56,56,56,56,56,56,56,56,56,56,56,56,56,56,56,56,56,56,56,56,56,56,56,56,56,56,56,56,56,56,41,41,55,
55,41,41,56,56,56,56,56,56,56,56,56,2,56,56,56,56,56,56,56,56,56,56,56,56,56,56,56,56,56,56,56,56,56,56,56,56,56,56,56,41,41,41,56,56,56,56,56,56,56,56,56,56,56,56,56,56,56,56,56,56,56,56,56,56,56,56,25,49,49,49,49,26,56,56,56,56,41,41,55,
55,41,41,56,56,56,56,56,56,56,56,56,2,56,56,56,56,56,56,56,56,56,56,56,56,56,56,56,56,56,56,56,56,56,56,56,56,56,56,56,41,41,41,56,56,56,56,56,56,56,56,56,56,56,56,56,56,56,56,56,56,56,56,56,56,56,56,56,56,56,56,56,56,56,56,56,56,41,41,55,
55,41,41,56,56,56,56,56,56,56,56,56,2,56,56,56,56,56,56,56,56,56,56,56,56,56,56,56,56,56,56,56,56,56,56,56,56,56,56,56,41,41,41,56,56,56,56,56,56,56,56,56,56,56,56,56,56,56,56,56,56,56,56,56,56,56,56,56,56,56,56,56,56,56,56,56,56,41,41,55,
55,41,41,56,56,56,56,56,56,56,56,56,2,56,56,56,56,56,56,56,56,56,56,56,56,56,56,56,56,56,56,56,56,56,56,56,56,56,56,56,41,41,41,56,56,56,56,56,56,56,56,56,56,56,56,56,56,56,56,37,29,38,56,56,56,56,56,56,56,56,56,56,56,56,56,56,56,41,41,55,
55,41,41,56,56,25,49,49,49,49,49,49,49,49,49,49,49,49,26,56,56,56,56,56,56,56,56,56,56,56,56,56,56,56,56,56,56,56,56,56,41,41,41,56,56,56,56,56,56,56,56,56,56,56,56,56,56,56,56,55,51,55,56,56,56,56,56,56,56,56,56,56,56,56,56,56,56,41,41,55,
55,41,41,56,56,56,56,4,56,56,56,56,56,56,56,56,56,56,56,56,56,56,56,56,56,56,56,56,56,56,56,56,56,56,56,56,56,56,56,56,41,41,41,56,56,56,56,56,56,56,56,56,56,56,56,56,56,56,56,55,51,55,56,56,56,56,56,56,56,56,56,56,56,56,56,56,5,41,41,55,
55,41,41,56,56,56,56,56,56,56,56,56,56,56,56,56,56,56,56,56,56,56,56,56,56,56,56,56,56,56,56,56,56,56,56,56,56,56,56,5,41,41,41,56,56,56,56,56,56,25,49,49,49,49,49,2,49,49,49,49,49,49,49,49,49,49,49,49,49,49,49,49,49,49,49,26,56,41,41,55,
55,41,41,56,56,56,56,56,56,56,56,56,56,56,56,56,56,56,56,56,56,56,25,49,49,49,49,49,49,49,26,56,56,56,56,56,56,56,56,56,41,41,41,56,56,56,56,56,56,56,56,56,56,56,56,2,56,56,56,56,56,56,56,56,56,56,56,56,56,56,56,56,56,56,56,56,56,41,41,55,
55,41,41,56,56,56,56,56,56,56,56,56,56,56,56,56,56,56,56,56,56,56,56,56,56,56,56,4,56,56,56,56,56,56,56,56,56,56,56,56,41,41,41,56,56,56,56,56,56,56,56,56,56,56,56,2,56,56,56,56,56,56,56,56,56,56,56,56,56,56,56,56,56,56,56,56,56,41,41,55,
55,41,41,56,56,56,56,56,56,56,56,56,56,56,56,56,56,56,56,56,56,56,56,56,56,56,56,56,56,56,56,56,56,56,56,56,56,56,56,56,41,41,41,56,56,56,56,56,56,56,56,56,56,56,56,2,56,56,56,56,56,56,56,56,56,56,56,56,56,56,56,56,56,56,56,56,56,41,41,55,
55,41,41,56,56,56,56,56,56,56,56,56,56,56,56,56,56,56,56,56,56,56,56,56,56,56,56,56,56,56,56,56,56,56,56,56,56,56,56,56,41,41,41,56,56,56,56,56,56,56,56,56,56,56,56,2,56,56,56,56,56,56,56,56,56,56,56,56,56,56,56,56,56,56,56,56,56,41,41,55,
55,41,41,56,56,56,56,56,56,56,56,56,56,56,56,56,56,56,56,56,56,56,56,56,56,56,56,56,56,56,56,56,56,56,56,56,56,56,56,56,41,41,41,56,56,56,56,56,56,56,56,56,56,56,56,2,56,56,56,56,56,56,56,56,56,56,56,56,56,56,56,56,56,56,56,56,56,41,41,55,
55,41,41,56,56,56,56,56,56,56,56,56,56,56,56,56,56,56,56,56,56,56,56,56,56,56,56,56,56,56,56,56,56,56,25,49,49,49,49,26,41,41,41,56,56,56,56,56,56,56,56,56,56,56,56,2,56,56,56,56,56,56,56,56,56,56,56,56,56,56,56,56,56,56,56,56,56,41,41,55,
55,41,41,56,56,56,56,56,56,56,56,56,56,56,56,56,56,56,56,56,56,56,56,56,56,56,56,56,56,56,56,56,56,56,56,56,56,4,56,56,41,41,41,56,56,56,56,56,56,56,56,56,56,56,56,2,56,56,56,56,56,56,56,56,56,56,56,56,56,56,56,56,56,56,56,56,56,41,41,55,
55,41,41,56,56,56,56,56,56,56,56,56,56,56,56,56,56,56,56,56,56,56,56,25,2,49,49,49,49,49,26,56,56,56,56,56,56,56,56,56,41,41,41,56,56,56,56,56,56,56,56,56,56,56,56,2,56,56,56,56,56,56,56,56,56,56,56,56,56,56,56,56,56,56,56,56,56,41,41,55,
55,41,41,56,56,56,56,56,56,56,56,56,56,56,56,56,56,56,56,56,56,56,56,56,2,56,56,56,56,56,56,56,56,56,56,56,56,56,56,56,41,41,41,56,56,56,56,56,56,56,56,56,56,56,56,2,56,56,56,56,56,56,56,56,56,56,56,56,56,56,56,56,56,56,56,56,56,41,41,55,
55,41,41,56,56,56,56,56,56,56,56,56,56,56,56,56,56,56,56,56,56,56,56,56,2,56,56,56,56,56,56,56,56,56,56,56,56,56,56,56,41,41,41,56,56,56,56,56,56,56,56,56,56,56,56,2,56,56,56,56,56,56,56,56,56,56,56,56,56,56,56,56,56,56,56,56,56,41,41,55,
55,41,41,56,56,56,56,56,56,56,56,56,56,56,56,56,56,56,56,56,56,56,56,56,2,56,56,56,56,56,56,56,56,56,56,56,56,56,56,56,41,41,41,56,56,56,56,56,56,56,56,56,56,56,56,2,56,56,56,56,56,56,56,56,56,56,56,56,56,56,56,56,56,56,56,56,56,41,41,55,
55,41,41,56,56,56,56,56,56,56,56,56,56,56,56,56,56,56,56,56,56,56,56,56,2,56,56,56,56,56,56,56,56,56,56,56,56,56,56,56,41,41,41,56,56,56,56,56,56,56,56,56,56,56,56,2,56,56,56,56,25,49,49,49,49,49,49,49,49,49,26,56,56,56,56,56,56,41,41,55,
55,41,41,56,56,56,56,56,56,56,56,56,56,56,56,56,56,56,56,56,56,56,56,56,2,56,56,56,56,56,56,56,56,56,56,56,56,56,56,56,41,41,41,56,56,56,56,56,56,56,56,56,56,56,56,2,56,56,56,56,56,56,56,56,56,56,56,56,56,56,56,56,56,56,56,56,56,41,41,55,
55,41,41,56,56,56,56,56,56,56,56,56,56,56,56,56,56,56,56,56,56,56,56,56,2,56,56,56,56,56,56,56,56,56,56,56,56,56,56,5,41,41,41,56,56,56,56,56,56,56,56,56,56,56,56,2,56,56,56,56,56,56,56,56,56,56,56,56,56,56,56,56,56,56,56,56,56,41,41,55,
55,41,41,56,56,56,56,56,56,56,56,56,56,56,56,25,49,2,49,49,49,49,49,49,49,26,56,56,56,56,56,56,56,56,56,56,56,56,56,56,45,41,46,56,56,56,56,56,56,56,56,56,56,56,56,2,56,56,56,56,56,56,56,56,56,56,56,56,56,56,56,56,56,56,56,56,5,41,41,55,
55,41,41,56,56,56,56,56,56,56,56,56,56,56,56,56,56,2,56,56,56,56,56,56,56,56,56,56,56,56,56,56,56,56,56,56,56,56,56,56,56,56,56,56,56,56,56,56,56,56,56,25,49,49,49,49,49,49,26,56,56,56,56,56,56,56,56,56,56,56,56,56,56,56,56,56,56,41,41,55,
55,41,41,56,56,56,56,56,56,56,56,56,56,56,56,56,56,2,56,56,56,56,56,56,56,56,56,56,56,56,56,56,56,56,56,56,56,56,56,56,56,56,56,56,56,56,56,56,56,56,56,56,56,56,56,56,56,56,56,56,56,56,56,56,56,56,56,56,56,56,56,56,56,56,56,56,56,41,41,55,
55,41,41,56,56,56,56,56,56,56,56,56,56,56,56,56,56,2,56,56,56,56,56,56,56,56,56,56,56,56,56,56,56,56,56,56,56,56,56,56,56,56,56,56,56,56,56,56,56,56,56,56,56,56,56,56,56,56,56,56,56,56,56,56,56,56,56,56,56,56,56,56,56,56,56,56,56,41,41,55,
55,41,41,56,56,56,56,56,56,56,56,56,56,56,56,56,56,2,56,56,56,56,56,56,56,56,56,56,56,56,56,56,56,56,56,56,56,56,56,56,56,56,56,56,56,56,56,56,56,56,56,56,56,56,56,56,56,56,56,56,56,56,56,56,56,56,56,56,56,56,56,56,56,2,56,56,56,41,41,55,
32,33,34,49,49,49,49,49,49,49,49,49,49,49,49,49,49,49,49,49,49,49,49,49,49,49,49,49,49,49,49,49,49,49,49,49,49,49,49,49,49,49,49,49,49,49,49,49,49,49,49,49,49,49,49,49,49,49,49,49,49,49,49,49,49,49,49,49,49,49,49,49,49,2,56,56,56,41,41,55,
40,41,42,29,29,29,29,29,29,29,29,29,29,29,29,29,29,29,29,29,29,29,29,29,29,29,29,29,29,29,29,29,29,29,29,29,29,29,29,29,29,29,29,29,29,29,29,29,29,29,29,29,29,29,29,29,29,29,29,29,29,29,29,29,29,29,29,29,29,29,29,29,29,2,56,56,56,41,41,55,
48,49,50,33,33,33,33,33,33,33,33,33,33,33,33,33,33,33,33,33,33,33,33,33,33,33,33,33,33,33,33,33,33,33,33,33,33,33,33,33,33,33,33,33,33,33,33,33,33,33,33,33,33,33,33,33,33,33,33,33,33,33,33,33,33,33,33,33,33,33,33,33,33,2,56,56,56,41,41,55,
56,56,56,56,56,56,56,56,56,56,56,56,56,56,56,56,56,56,56,56,56,56,56,56,56,56,56,56,56,56,56,56,56,56,56,56,56,56,56,56,55,41,41,56,56,56,56,56,56,56,56,56,4,56,56,56,56,56,56,56,56,56,56,56,56,56,56,56,56,56,56,56,56,2,56,56,56,41,41,55,
56,56,56,56,56,56,56,56,56,56,56,56,56,56,56,56,56,56,56,56,56,56,56,56,56,56,56,56,56,56,56,56,56,56,56,56,56,56,56,56,55,41,41,56,56,56,56,56,56,56,56,56,56,56,56,56,56,56,56,56,56,56,56,56,56,56,56,56,56,56,56,56,56,2,56,56,56,41,41,55,
56,56,56,56,56,56,56,56,56,56,56,56,56,56,56,56,56,56,56,56,56,56,56,56,56,56,56,56,56,56,56,56,56,56,56,56,56,56,56,56,55,41,41,56,56,56,56,56,56,56,56,56,56,56,56,56,56,56,56,56,56,56,56,56,56,56,56,56,56,56,56,56,56,2,56,56,56,41,41,55,
56,56,56,56,56,56,56,56,56,56,56,56,56,56,56,56,56,56,56,56,56,56,56,56,56,56,56,56,56,56,56,56,56,56,56,56,56,56,56,56,55,41,41,56,56,56,56,56,56,56,56,56,56,56,56,56,56,56,56,56,56,56,56,56,56,56,56,56,56,56,56,56,56,2,56,56,56,41,41,55,
56,56,56,56,56,56,56,56,56,56,56,56,56,56,56,56,56,56,56,56,56,56,56,56,56,56,56,56,56,56,56,56,56,56,56,56,56,56,56,56,55,41,41,56,56,56,56,56,56,56,56,56,56,56,56,56,56,56,56,56,56,56,56,56,56,56,56,56,56,56,56,56,56,2,56,56,56,41,41,55,
56,56,56,56,56,56,56,56,56,56,56,56,56,56,56,56,56,56,56,56,56,56,56,56,56,56,56,56,56,56,56,56,56,56,56,56,56,56,56,56,55,41,41,56,56,56,56,56,56,56,56,56,56,56,56,56,56,56,56,56,56,56,56,56,56,25,49,49,49,49,49,49,49,49,26,56,56,41,41,55,
56,56,56,56,56,56,56,56,56,56,56,56,56,56,56,56,56,56,56,56,56,56,56,56,56,56,56,56,56,56,56,56,56,56,56,56,56,56,56,56,55,41,41,56,56,56,56,56,56,56,56,56,56,56,56,56,56,56,56,56,56,56,56,56,56,56,56,4,56,56,56,56,56,56,56,56,56,41,41,55,
56,56,56,56,56,56,56,56,56,56,56,56,56,56,56,56,56,56,56,56,56,56,56,56,56,56,56,56,56,56,56,56,56,56,56,56,56,56,56,56,55,41,41,56,56,56,56,56,56,56,56,56,56,56,56,56,56,56,56,56,25,26,56,56,56,56,56,56,56,56,56,56,56,56,56,56,56,41,41,55,
56,56,56,56,56,56,56,56,56,56,56,56,56,56,56,56,56,56,56,56,56,56,56,56,56,56,56,56,56,56,56,56,56,56,56,56,56,56,56,56,55,41,41,56,56,56,56,56,56,56,56,56,56,56,56,56,56,56,56,56,56,56,56,56,56,56,56,56,56,56,56,56,56,56,56,56,56,41,41,55,
56,56,56,56,56,56,56,56,56,56,56,56,56,56,56,56,56,56,56,56,56,56,56,56,56,56,56,56,56,56,56,56,56,56,56,56,56,56,56,56,55,41,41,56,56,56,56,56,56,56,56,56,56,56,56,56,56,56,56,56,56,56,56,56,56,56,56,56,56,56,56,56,56,56,56,56,5,41,41,55,
56,56,56,56,56,56,56,56,56,56,56,56,56,56,56,56,56,56,56,56,56,56,56,56,56,56,56,56,56,56,56,56,56,56,56,56,56,56,56,56,55,41,41,56,56,56,56,25,49,2,49,49,49,49,49,49,49,26,56,56,56,56,56,56,56,56,56,56,56,56,56,56,56,56,56,56,56,41,41,55,
56,56,56,56,56,56,56,56,56,56,56,56,56,56,56,56,56,56,56,56,56,56,56,56,56,56,56,56,56,56,56,56,56,56,56,56,56,56,56,56,55,41,41,56,56,56,56,56,56,2,56,56,56,56,56,56,56,56,56,56,56,56,56,56,56,56,56,56,56,56,56,56,56,56,56,56,56,41,41,55,
56,56,56,56,56,56,56,56,56,56,56,56,56,56,56,56,56,56,56,56,56,56,56,56,56,56,56,56,56,56,56,56,56,56,56,56,56,56,56,56,55,41,41,56,56,56,56,56,56,2,56,56,56,56,56,56,56,56,56,56,56,56,56,56,56,56,56,56,56,56,56,56,56,56,56,56,56,41,41,55,
56,56,56,56,56,56,56,56,56,56,56,56,56,56,56,56,56,56,56,56,56,56,56,56,56,56,56,56,56,56,56,56,56,56,56,56,56,56,56,56,55,41,41,56,56,56,56,56,56,2,56,56,56,56,56,56,56,56,56,56,56,56,56,56,56,56,56,56,56,56,56,56,56,56,56,56,56,41,41,55,
56,56,56,56,56,56,56,56,56,56,56,56,56,56,56,56,56,56,56,56,56,56,56,56,56,56,56,56,56,56,56,56,56,56,56,56,56,56,56,56,55,41,41,56,56,56,56,56,56,2,56,56,56,56,56,56,56,56,56,56,56,56,56,56,56,56,56,56,56,56,56,56,56,56,56,56,56,41,41,55,
56,56,56,56,56,56,56,56,56,56,56,56,56,56,56,56,56,56,56,56,56,56,56,56,56,56,56,56,56,56,56,56,56,56,56,56,56,56,56,56,55,41,41,56,56,56,56,56,56,2,56,56,56,56,56,56,56,56,56,56,56,56,56,56,56,56,56,56,56,56,56,56,56,56,56,56,56,41,41,55,
56,56,56,56,56,56,56,56,56,56,56,56,56,56,56,56,56,56,56,56,56,56,56,56,56,56,56,56,56,56,56,56,56,56,56,56,56,56,56,56,55,41,41,56,56,56,56,56,56,2,56,56,56,56,56,56,56,56,56,56,56,56,56,56,56,56,56,56,56,56,56,56,56,56,56,56,56,41,41,55,
56,56,56,56,56,56,56,56,56,56,56,56,56,56,56,56,56,56,56,56,56,56,56,56,56,56,56,56,56,56,56,56,56,56,56,56,56,56,56,56,55,41,41,56,56,56,56,56,56,2,56,56,56,56,56,56,56,56,56,25,49,49,49,49,49,49,26,56,56,56,56,56,56,56,56,56,56,41,41,55,
56,56,56,56,56,56,56,56,56,56,56,56,56,56,56,56,56,56,56,56,56,56,56,56,56,56,56,56,56,56,56,56,56,56,56,56,56,56,56,56,55,41,41,56,56,56,56,56,56,2,56,56,56,56,56,56,56,56,56,56,56,56,4,56,56,56,56,56,56,56,56,56,56,56,56,56,56,41,41,55,
56,56,56,56,56,56,56,56,56,56,56,56,56,56,56,56,56,56,56,56,56,56,56,56,56,56,56,56,56,56,56,56,56,56,56,56,56,56,56,56,55,41,41,56,25,49,49,49,49,49,49,49,49,26,56,56,56,56,56,56,56,56,56,56,56,56,56,56,56,56,56,56,56,56,56,56,56,41,41,55,
56,56,56,56,56,56,56,56,56,56,56,56,56,56,56,56,56,56,56,56,56,56,56,56,56,56,56,56,56,56,56,56,56,56,56,56,56,56,56,56,55,41,41,56,56,4,56,56,56,56,56,56,56,56,56,56,56,56,56,56,56,56,56,56,56,56,56,56,56,56,25,49,49,49,49,26,56,41,41,55,
56,56,56,56,56,56,56,56,56,56,56,56,56,56,56,56,56,56,56,56,56,56,56,56,56,56,56,56,56,56,56,56,56,56,56,56,56,56,56,56,55,41,41,56,56,56,56,56,56,56,56,56,56,56,56,56,56,56,56,56,56,56,56,56,56,56,56,56,56,56,56,56,56,56,56,56,56,41,41,55,
56,56,56,56,56,56,56,56,56,56,56,56,56,56,56,56,56,56,56,56,56,56,56,56,56,56,56,56,56,56,56,56,56,56,56,56,56,56,56,56,55,41,41,56,56,56,56,56,56,56,56,56,56,56,56,56,56,56,56,56,56,56,56,56,56,56,56,56,56,56,56,56,56,56,56,56,56,41,41,55,
56,56,56,56,56,56,56,56,56,56,56,56,56,56,56,56,56,56,56,56,56,56,56,56,56,56,56,56,56,56,56,56,56,56,56,56,56,56,56,56,55,41,41,56,56,56,56,56,56,56,56,56,56,56,56,56,56,56,56,56,56,56,56,56,56,56,56,56,56,56,56,56,56,56,56,56,56,41,41,55,
56,56,56,56,56,56,56,56,56,56,56,56,56,56,56,56,56,56,56,56,56,56,56,56,56,56,56,56,56,56,56,56,56,56,56,56,56,56,56,56,55,41,41,56,56,56,56,56,56,56,56,56,56,56,56,56,56,56,56,25,49,49,49,49,49,49,49,49,26,56,56,56,56,56,56,56,56,41,41,55,
56,56,56,56,56,56,56,56,56,56,56,56,56,56,56,56,56,56,56,56,56,56,56,56,56,56,56,56,56,56,56,56,56,56,56,56,56,56,56,56,55,41,41,56,56,56,56,56,56,56,56,56,56,56,56,56,56,56,56,56,56,56,56,56,56,56,56,56,56,56,56,56,56,56,56,56,56,41,41,55,
56,56,56,56,56,56,56,56,56,56,56,56,56,56,56,56,56,56,56,56,56,56,56,56,56,56,56,56,56,56,56,56,56,56,56,56,56,56,56,56,55,41,41,56,56,56,56,56,56,56,56,56,56,56,56,56,56,56,56,56,56,56,56,56,56,56,56,56,56,56,56,56,56,56,56,56,5,41,41,55,
56,56,56,56,56,56,56,56,56,56,56,56,56,56,56,56,56,56,56,56,56,56,56,56,56,56,56,56,56,56,56,56,56,56,56,56,56,56,56,56,55,41,41,56,56,56,56,56,25,49,49,49,49,49,49,26,56,56,56,56,56,56,56,56,56,56,56,56,56,56,56,56,56,56,56,56,56,41,41,55,
56,56,56,56,56,56,56,56,56,56,56,56,56,56,56,56,56,56,56,56,56,56,56,56,56,56,56,56,56,56,56,56,56,56,56,56,56,56,56,56,55,41,41,56,56,56,56,56,56,2,56,56,4,56,56,56,56,56,56,56,56,56,56,56,56,56,56,56,56,56,56,56,56,56,56,56,56,41,41,55,
56,56,56,56,56,56,56,56,56,56,56,56,56,56,56,56,56,56,56,56,56,56,56,56,56,56,56,56,56,56,56,56,56,56,56,56,56,56,56,56,55,41,41,56,56,56,56,56,56,2,56,56,56,56,56,56,56,56,56,56,56,56,56,56,56,56,56,56,56,56,56,56,56,56,56,56,56,41,41,55,
56,56,56,56,56,56,56,56,56,56,56,56,56,56,56,56,56,56,56,56,56,56,56,56,56,56,56,56,56,56,56,56,56,56,56,56,56,56,56,56,55,41,41,56,56,56,56,56,56,2,56,56,56,56,56,56,56,56,56,56,56,56,56,56,56,56,56,56,56,56,56,56,56,56,56,56,56,41,41,55,
56,56,56,56,56,56,56,56,56,56,56,56,56,56,56,56,56,56,56,56,56,56,56,56,56,56,56,56,56,56,56,56,56,56,56,56,56,56,56,56,55,41,41,56,56,56,56,56,56,2,56,56,56,56,56,56,56,56,56,56,56,56,56,56,56,37,29,38,56,56,56,56,56,56,56,56,56,41,41,55,
56,56,56,56,56,56,56,56,56,56,56,56,56,56,56,56,56,56,56,56,56,56,56,56,56,56,56,56,56,56,56,56,56,56,56,56,56,56,56,56,55,41,41,56,56,56,56,56,56,2,56,56,56,56,56,56,56,56,56,56,56,56,56,56,56,55,51,55,56,56,56,56,56,56,56,56,56,41,41,55,
56,56,56,56,56,56,56,56,56,56,56,56,56,56,56,56,56,56,56,56,56,56,56,56,56,56,56,56,56,56,56,56,56,56,56,56,56,56,56,56,55,41,41,56,56,56,56,56,56,2,56,56,56,56,56,56,56,56,56,56,56,56,56,56,56,55,51,55,56,56,56,56,56,56,56,56,56,41,41,55,
56,56,56,56,56,56,56,56,56,56,56,56,56,56,56,56,56,56,56,56,56,56,56,56,56,56,56,56,56,56,56,56,56,56,56,56,56,56,56,56,32,33,34,41,41,41,41,41,41,41,41,41,41,41,41,41,41,41,41,41,41,41,41,41,41,41,41,41,41,41,41,41,41,41,41,41,41,32,33,34,
56,56,56,56,56,56,56,56,56,56,56,56,56,56,56,56,56,56,56,56,56,56,56,56,56,56,56,56,56,56,56,56,56,56,56,56,56,56,56,56,40,41,42,41,41,41,41,41,41,41,41,41,41,41,41,41,41,41,41,41,41,41,41,41,41,41,41,41,41,41,41,41,41,41,41,41,41,40,41,42,
56,56,56,56,56,56,56,56,56,56,56,56,56,56,56,56,56,56,56,56,56,56,56,56,56,56,56,56,56,56,56,56,56,56,56,56,56,56,56,56,48,49,50,39,39,39,39,39,39,39,39,39,39,39,39,39,39,39,39,39,39,39,39,39,39,39,39,39,39,39,39,39,39,39,39,39,39,48,49,50,

